1111111111111111111111111111111111111111111111111111111111111111111111111111111111111111
1010001011101110101111111111111111111111111110100010111011101011111111111111111111111111
1010101111111111111011111111111111111111111110101011111111111110111111111111111111111111
1000000000000000001111111111111111111111111110000000000000000011111111111111111111111111
1011101011111010111011111111111111111111111110111010111110101110111111111111111111111111
1111111011101010001011111111111111111111111111111110111010100010111111111111111111111111
1000111011111010111011111111111111111111111110001110111110101110111111111111111111111111
1010101011111110101011111111111111111111111110101010111111101010111111111111111111111111
1110111010001010111011111111111111111111111111101110100010101110111111111111111111111111
1000C00C101010000000E111111111111111111111111000C00C101010000000E11111111111111111111111
1111111111111111111111111111111111111111111111111111111111111111111111111111111111111111
1111111111111111111111111111111111111111111111111111111111111111111111111111111111111111
1010001011101110101111111111111111111111111110100010111011101011111111111111111111111111
1010101111111111111011111111111111111111111110101011111111111110111111111111111111111111
100000000000000000111111111111111111111111111000000P000000000011111111111111111111111111
1011101011111010111011111111111111111111111110111010111110101110111111111111111111111111
1111111011101010001011111111111111111111111111111110111010100010111111111111111111111111
1000111011111010111011111111111111111111111110001110111110101110111111111111111111111111
1010101011111110101011111111111111111111111110101010111111101010111111111111111111111111
1110111010001010111011111111111111111111111111101110100010101110111111111111111111111111
1000C00C101010000000E111111111111111111111111000C00C101010000000E11111111111111111111111
1111111111111111111111111111111111111111111111111111111111111111111111111111111111111111