111111111111111111111
1PC0000000000000000E1
100000010000000000001
100000000001000000001
111111111111111111111